OOOOOOOOOOOOOOOOOOOOOOOOOOOOOOOO
OOOOOOOOOOOOOOOOOOOOOOOOOOOOOOOO
OOOOOOOOOOOOOOOOOOOOOOOOOOOOOOOO
OOOOOOOOOOOOOOOOOOOOOOOOOOOOOOOO
OOOOOOOOOOOOOOOOOOOOOOOOOOOOOOOO
OOOOOOOOOOOOOOOOOOOOOOOOOOOOOOOO
OOOOOOOOOOOOOOOOOOOOOOOOOOOOOOOO
OOOOOOOOOOOOOOOOOOOOOOOOOOOOOOOO
OOOOOOOOOOOOOOOOOOOOOOOOOOOOOOOO
OOOOOOOOOOOOOOOOOOOOOOOOOOOOOOOO
OOOOOOOOOOOOOOOOOOOOOOOOOOOOOOOO
OOOOOOOOOOOOOOOOOOOOOOOOOOOOOOOO
OOOOOOOOOOOOOOOOOOOOOOOOOOOOOOOO
OOOOOOOOOOOOOOOOOOOOOOOOOOOOOOOO
OOOOOOOOOOOOOOOOOOOOOOOOOOOOOOOO
OOOOOOOOOOOOOOOOOOOOOOOOOOOOOOOO
OOOOOOOOOOOOOOOOOOOOOOOOOOOOOOOO
OOOOOOOOOOOOOOOOOOOOOOOOOOOOOOOO
;
SSSSSSSSSSSSSSSSSSSSSSSSSSSSSSSS
SXXXXSSXXXSSXXXXXXXXXXXXXXXXXXXS
SXXXXSSXXXSSXXXXXXXXXXXXXXXXXXXS
SXXXXSSXXXSSSSSSSSSSSSSXXXSSSSSS
SSSXXSSSXSSSSSSSSSSSSSSSSSSSSSSS
SSSXXSSSXSSSSSSSSSSSSSSSSSSSSSSS
SSSXXSSSXSSSSSSSSSXXXSSSXSSSXXXS
SSSXXSSSXSSSSSSSSSXXXXSSXSSXXXXS
SSSXXSSXXSSSSSSSSSXXXXSSXSSXXXXS
SSSXXSSXTSSSXXXXXXXXXXXXXXXXXXXS
SSSXXSSSSSSXXXXXXXXXXXXXXXXXXXXS
SSSXXSSSSSXXXXXXXXXXXXXXXXXXXXXS
SSSXXSSSSXXXXXXXXXXXXXXXUXXXXXXS
SSSXXSSSXXXXSSSSSSSSSSSSSSXXXXXS
SSSXXSSXXXXSSSSSSSSSSSSSSSSXXXXS
SSSXXXXXXXSSSSSSSSSSSSSSSSSSXXXS
SSSXXXXXXSSSSSSSSSSSSSSSSSSSSSSS
SSSSSSSSSSSSSSSSSSSSSSSSSSSSSSSS
;
XXXXXXXX?XXXXXXXXXXXXXXXXXXXXXXX
XXXXXXXXXXXXXXXXXXXXXXXXXXXXXXXX
XXXXXXXXXXXXXXXXXXXXXXXXXXXXXXXX
XXXXXXXXXXXXXXXXXXXXXXXXXXXXXXXX
XXXXXXXXXXXXXXXXXXXXXXXXXXXXXXXX
XXXXXXXXXXXXXXXXXXXXXXXXXXXXXXXX
XXXXXXXXXXXXXXXXXXXXXXXXXXXXXXXX
XXXXXXXXXXXXXXXXXXXXXXXXXXXXXXXX
XXXXXXXXXXXXXXXXXXXXXXXXXXXXXXXX
XXXXXXXXXXXXXXXXXXXXXXXXXXXXXXXX
XXXXXXX/XXXXXXXXXXXXXXXXXXXXXXXX
XXXXXXXXXXXXXXXXXXXXXXXXXXXXXXXX
XXXXXXXXXXXXXXXXXXXXXXXXXXXXXXXX
XXXXXXXXXXXXXXXXXXXXX/XXXXXXXXXX
XXXXXXXXXXXXXXXXXXXXXXXXXXXXXXXX
XXXXXXXXXXXXXXXXXXXXXXXXXXXXXXXX
XXXXXXXXXXXXXXXXXXXXXXXXXXXXXXXX
XXXXXXXXXXXXXXXXXXXXXXXXXXXXXXXX