OOOOOOOOOOOOOOOOOOOOOOOOOOOOOOOO
OOOOOOOOOOOOOOOOOOOOOOOOOOOOOOOO
OOOOOOOOOOOOOOOOOOOOOOOOOOOOOOOO
OOOOOOOOOOOOOOOOOOOOOOOOOOOOOOOO
OOOOOOOOOOOOOOOOOOOOOOOOOOOOOOOO
OOOOOOOOOOOOOOOOOOOOOOOOOOOOOOOO
OOOOOOOOOOOOOOOOOOOOOOOOOOOOOOOO
OOOOOOOOOOOOOOOOOOOOOOOOOOOOOOOO
OOOOOOOOOOOOOOOOOOOOOOOOOOOOOOOO
OOOOOOOOOOOOOOOOOOOOOOOOOOOOOOOO
OOOOOOOOOOOOOOOOOOOOOOOOOOOOOOOO
OOOOOOOOOOOOOOOOOOOOOOOOOOOOOOOO
OOOOOOOOOOOOOOOOOOOOOOOOOOOOOOOO
OOOOOOOOOOOOOOOOOOOOOOOOOOOOOOOO
OOOOOOOOOOOOOOOOOOOOOOOOOOOOOOOO
OOOOOOOOOOOOOOOOOOOOOOOOOOOOOOOO
OOOOOOOOOOOOOOOOOOOOOOOOOOOOOOOO
OOOOOOOOOOOOOOOOOOOOOOOOOOOOOOOO
;
SSSSSSSSSSSSSSSSSSSSSSSSSSSSSSSS
SXSXXSSSSSXXSXXXXXXSXXSSSSSXXSXS
SXXXXSXXXSXXSXXXXXXSXXSXXXSXXXXS
SXXXXXXXXXXXSSSSSSSSXXXXXXXXXXXS
SXXXXRXXXRXXXXXXXXXXXXRXXXRXXXXS
SXXXXSUXXSXXXXXXXXXXXXSXXTSXXXXS
SXXXXSSSSSXXXXXXXXXXXXSSSSSXXXXS
SXXXXXXXXXXXXXXXXXXXXXXXXXXXXXXS
SXXXXXXXXXXXXXSXXSXXXXXXXXXXXXXS
SXXXXXXXXXXXSXXXXXXXXXXXXXXXXXXS
SXXXXXXXXXXXXXXSSXXXXXXXXXXXXXXS
SXXXXXXXXXXXXXXXXXXXXXXXXXXXXXXS
SXXXXXXXXXSXXXSXXSXSXXXXXXXXUXXS
SXXXXXXXXXXXXXSSSSXXXXXXXXXXSXXS
SXXXXXXTXXXXXXXXXXXXXXXXSXXSXXXS
SXXXXXXSXXXXXXXXXXXXSXXSXXXXXXXS
SXXXXXXXXXXXXXSXXSXXXXXXXXXXXXXS
SSSSSSSSSSSSSSSSSSSSSSSSSSSSSSSS
;
XXXXXXXXXXXXXXXXXXXXXXXXXXXXXXXX
XXXXXXXXXXXXXXXXXXXXXXXXXXXXXXXX
XXXXXXXXXXXXXXXXXXXXXXXXXXXXXXXX
XXXXXXXXXXXXXX/XX|XXXXXXXXXXXXXX
XXXXXXXXXXXXXXXXXXXXXXXXXXXXXXXX
XXXXXXXXXXXXXXXXXXXXXXXXXXXXXXXX
XXXXXXXX|XXXXXXXXXXXXXX/XXXXXXXX
XXXXXXXXXXXXXXXXXXXXXXXXXXXXXXXX
XXXXXXXXXXXXXXXXXXXXXXXXXXXXXXXX
XXXXXXXXXXXX/XXXXXXXXXXXXXXXXXXX
XXXXXXXXXXXXXXXXXXXXXXXXXXXXXXXX
XXXXXXXXXXXXXXXXXXXXXXXXXXXXXXXX
XXXXXXXXXXXXXXXXXXXXXXXXXXXXXXXX
XXXXXXXXXXXXXXX|/XXXXXXXXXXXXXXX
XXXXXXXXXXXXXXXXXXXXXXXXXXXXXXXX
XXXXXXXXXXXXXXXXXXXX|XXXXXXXXXXX
XXXXXXXXXXXXXXXXXXXXXXXXXXXXXXXX
XXXX/|XXXXXXXXXXXXXXXXXXXX/|XXXX