OOOOOOOOOOOOOOOOOOOOOOOOOOOOOOOO
OOOOOOOOOOOOOOOOOOOOOOOOOOOOOOOO
OOOOOOOOOOOOOOOOOOOOOOOOOOOOOOOO
OOOOOOOOOOOOOOOOOOOOOOOOOOOOOOOO
OOOOOOOOOOOOOOOOOOOOOOOOOOOOOOOO
OOOOOOOOOOOOOOOOOOOOOOOOOOOOOOOO
OOOOOOOOOOOOOOOOOOOOOOOOOOOOOOOO
OOOOOOOOOOOOOOOOOOOOOOOOOOOOOOOO
OOOOOOOOOOOOOOOOOOOOOOOOOOOOOOOO
OOOOOOOOOOOOOOOOOOOOOOOOOOOOOOOO
OOOOOOOOOOOOOOOOOOOOOOOOOOOOOOOO
OOOOOOOOOOOOOOOOOOOOOOOOOOOOOOOO
OOOOOOOOOOOOOOOOOOOOOOOOOOOOOOOO
OOOOOOOOOOOOOOOOOOOOOOOOOOOOOOOO
OOOOOOOOOOOOOOOOOOOOOOOOOOOOOOOO
OOOOOOOOOOOOOOOOOOOOOOOOOOOOOOOO
OOOOOOOOOOOOOOOOOOOOOOOOOOOOOOOO
OOOOOOOOOOOOOOOOOOOOOOOOOOOOOOOO
;
SSSSSSSSSSSSSSSSSSSSSSSSSSSSSSSS
SXXXXXXXXXXXXXXXXXXXXXXXXXXXXXXS
SXXXXXXXXXXXXXXXXXXXXXXXXXXXXXXS
SXXXXXXXXXXXXXXXXXXXXXXXXXXXXXXS
SSSXXSXXSXXSXXSXXSXXSXXSXXSXXSXS
SSSXXXXXXXXXXXXXXXXXXXXXXXXXXSXS
SSSXXXXXXXXXXXXXXXXXXXXXXXXXXSXS
SSSXXXXXXXXXXXXXXXXXXXXXXXXXXSXS
SSSXXXXXXXXXXXXXXXXXXXXXXXXXXSXS
SSSSSSSSXXXXXXXXXXXXXXXXXXXXXSXS
SSSSSSSSSXXSXXXXXXXXXXXXXXXXXSXS
SSSSSSSSSSXXXXSXXXXXXXXXXXXXXSXS
SSXXXSSSSSSXXXXXXSXXXXXXXXXXXSXS
SSXXXSSSSSSXXXXXXXXXSXXXXXXXXSXS
SSXXXXXXSSSXXXXXXXXXXXXSXXXXXXXS
SSXXXXXXSSSXXXXXXXXXXXXXXXSXXXXS
SSUXXXSXSSSXXXXXXXXXXXXXXXXXSSSS
SSSSSSSSSSSRRRRRRRRRRRRRRRRRSSSS
;
XXXXXXXXXXXXXXXXXXXXXXXXXXXXXXXX
XXXXXXXXXXXXXXXXXXXXXXXXXXXXXXXX
XXXXXXXXXXXXXXXXXXXXXXXXXXXXXXXX
XXXXXXXXXXXXXXXXXXXXXXXXXXXXXXXX
XXXXXXXXXXXXXXXXXXXXXXXXXXXXXXXX
XXXXXXXXXXXXXXXXXXXXXXXXXXXXXXXX
XXXXXXXXXXXXXXXXXXXXXXXXXXXXXXXX
XXXXXXXXXXXXXXXXXXXXXXXXXXXXXXXX
XXXXXXXXXXXXXXXXXXXXXXXXXXXXXXXX
XXXXXX/XXXXXXXXXXXXXXXXXXXXXXXXX
XXXXXXXXXXXXXXXXXXXXXXXXXXXXXXXX
XXXXXXXXXXXXXXXXXXXXXXXXXXXXXXXX
XXXXXXXXXXXXXXXXXXXXXXXXXXXXXXXX
XXXXXXXXXXXXXXXXXXXXXXXXXXXXXXXX
XXXXXXXXXXXXXXXXXXXXXXXXXXXXXXXX
XXXXXXXXXXXXXXXXXXXXXXXXXXXXXXXX
XXXXXXXXXXXXXXXXXXXXXXXXXXXXXX|X
XXX|XX/SXXXXXXXXXXXXXXXXXXXXXXXX