OOOOOOOOOOOOOOOOOOOOOOOOOOOOOOOO
OOOOOOOOOOOOOOOOOOOOOOOOOOOOOOOO
OOOOOOOOOOOOOOOOOOOOOOOOOOOOOOOO
OOOOOOOOOOOOOOOOOOOOOOOOOOOOOOOO
OOOOOOOOOOOOOOOOOOOOOOOOOOOOOOOO
OOOOOOOOOOOOOOOOOOOOOOOOOOOOOOOO
OOOOOOOOOOOOOOOOOOOOOOOOOOOOOOOO
OOOOOOOOOOOOOOOOOOOOOOOOOOOOOOOO
OOOOOOOOOOOOOOOOOOOOOOOOOOOOOOOO
OOOOOOOOOOOOOOOOOOOOOOOOOOOOOOOO
OOOOOOOOOOOOOOOOOOOOOOOOOOOOOOOO
OOOOOOOOOOOOOOOOOOOOOOOOOOOOOOOO
OOOOOOOOOOOOOOOOOOOOOOOOOOOOOOOO
OOOOOOOOOOOOOOOOOOOOOOOOOOOOOOOO
OOOOOOOOOOOOOOOOOOOOOOOOOOOOOOOO
OOOOOOOOOOOOOOOOOOOOOOOOOOOOOOOO
OOOOOOOOOOOOOOOOOOOOOOOOOOOOOOOO
OOOOOOOOOOOOOOOOOOOOOOOOOOOOOOOO
;
SSSSSSSSSSSSSSSSSSSSSSSSSSSSSSSS
SXXXXXXXXXXXXXXXXXXXXXXXXXXXXXXS
SXXTXXTXXTXXTXXTXXTXXTXXTXXTXXSS
SSSSSSSSSSSSSSSSSSSSSSSSSSSSSSSS
SXXXXXXXXXXXXXXXXXXXXXXXXXXXXXXS
SXXXXXXXXXXXXXXXXXXXXXXXXXXXXXXS
SXXXXXXXXXXXXXXXXXXXXXXXXXXXXXXS
SXXXXXXXXXXXXXXXXXXXXXXXXXXXXXXS
SXXXXXXXXXXXXXXXXXXXXXXXXXXXXXXS
SXXXXXXXXXXXXXXXXXXXXXXXXXXXXXXS
SXXXXXXXXXXXXXXXXXXXXXXXXXXXXUXS
SXXXXXXXXXXXXXXXXXXXXXXXXXXXXSSS
SXXXXXXXXXXXXXSXXXXXXXXXXXSXSSSS
SXXXXXXXXXXSXSSXXXXXXXXSXSSXSSSS
SXXXXXXXSXSSXSSXXXXXSXSSXSSXSXXS
SXXXXSXSSXSSXSSXXSXSSXSSXSSXSXXS
SXSXSSXSSXSSXSSXSSXSSXSSXSSXSXXS
SSSSSSSSSSSSSSSSSSSSSSSSSSSSSXXS
;
XXXXXXXXXXXXXXXXXXXXXXXXXXXXXXXX
XXXXXXXXXXXXXXXXXXXXXXXXXXXXXXXX
XXXXXXXXXXXXXXXXXXXXXXXXXXXXXXXX
XXXXXXXXXXXXXXXXXXXXXXXXXXXXXX/X
XXXXXXXXXXXXXXXXXXXXXXXXXXXXXXXX
XXXXXXXXXXXXXXXXXXXXXXXXXXXXXXXX
XXXXXXXXXXXXXXXXXXXXXXXXXXXXXXXX
XXXXXXXXXXXXXXXXXXXXXXXXXXXXXXXX
XXXXXXXXXXXXXXXXXXXXXXXXXXXXXXXX
XXXXXXXXXXXXXXXXXXXXXXXXXXXXXXXX
XXXXXXXXXXXXXXXXXXXXXXXXXXXXXXXX
XXXXXXXXXXXXXXXXXXXXXXXXXXXXXX|X
XXXXXXXXXXXXXXXXXXXXXXXXXXXXXXXX
XXXXXXXXXXXXXXXXXXXXXXXXXXXXX?~X
XXXXXXXXXXXXXXXXXXXXXXXXXXXXXXXX
XXXXXXXXXXXXXXXXXXXXXXXXXXXXXXXX
XXXXXXXXXXXXXXXXXXXXXXXXXXXXXXXX
XXXXXXXXXXXXXXXXXXXXXXXXXXXXXXXX