OOOOOOOOOOOOOOOOOOOOOOOOOOOOOOOO
OOOOOOOOOOOOOOOOOOOOOOOOOOOOOOOO
OOOOOOOOOOOOOOOOOOOOOOOOOOOOOOOO
OOOOOOOOOOOOOOOOOOOOOOOOOOOOOOOO
OOOOOOOOOOOOOOOOOOOOOOOOOOOOOOOO
OOOOOOOOOOOOOOOOOOOOOOOOOOOOOOOO
OOOOOOOOOOOOOOOOOOOOOOOOOOOOOOOO
OOOOOOOOOOOOOOOOOOOOOOOOOOOOOOOO
OOOOOOOOOOOOOOOOOOOOOOOOOOOOOOOO
OOOOOOOOOOOOOOOOOOOOOOOOOOOOOOOO
OOOOOOOOOOOOOOOOOOOOOOOOOOOOOOOO
OOOOOOOOOOOOOOOOOOOOOOOOOOOOOOOO
OOOOOOOOOOOOOOOOOOOOOOOOOOOOOOOO
OOOOOOOOOOOOOOOOOOOOOOOOOOOOOOOO
OOOOOOOOOOOOOOOOOOOOOOOOOOOOOOOO
OOOOOOOOOOOOOOOOOOOOOOOOOOOOOOOO
OOOOOOOOOOOOOOOOOOOOOOOOOOOOOOOO
OOOOOOOOOOOOOOOOOOOOOOOOOOOOOOOO
;
SSSSSSSSSSSSSSSSSSSSSSSSSSSSSSSS
SXXXXXSSSSSSSSSSSSSSSSSSSSSSXXXS
SXXXXXSSSSSSSSSSSSSSSSSSSSSSXXXS
SSSXXXSXXXXXXXXXSSSSSSSSSSSSXXXS
SSXXXXSTXXXXXXXXXXXXXXXXXXXXXXXS
SSXXXSSSSXXXXXXXXXXXXXXXXXXXXXXS
SSXXXXSXXSXXXXXXXXXXXXXXXXXXXXXS
SSSXXXSXXXSXXXXXXXXSXXXSXXSSXXXS
SSXXXXSXXXXSXXXXSXXXSXXXXXXSXXXS
SSXXXSSXXXXXSXXXXXXXXXXXXXXSXXXS
SSXXXXSXXXXXXSXXXXXXXXXXXXXSXXXS
SSSXXXSXXXXXXXXXXXXXXXXXXXXXXXXS
SSXXXXSXXXXXXXXXXXXXXXXXXXXXXXXS
SSXXXSXXXXXXXXXXXXXXXXXXXXXXXXXS
SSXXXXXXXXXXXXXXXXXXXXXXXXXXXXXS
SSSXXXXXSXXSXXSXXSXXSXXSXXSXXXXS
SSSXXSSXXXXXXXXXXXXXXXXXXXXXSSSS
SSSRRSSSSSSSSSSSSSSSSSSSSSSSSSSS
;
XXXXXXXXXXXXXXXXXXXXXXXXXXXXX?XX
XXXXXXXXXXXXXXXXXXXXXXXXXXXXXXXX
XXXXXXXXXXXXXXXXXXXXXXXXXXXXXXXX
XXXXXXXXXXXXXXXXXXXXXXXXXXXXXXXX
XXXXXXXXXXXXXXXXXXXXXXXXXXXXXXXX
XXXXXXXXXXXXXXXXXXXXXXXXXXXXXXXX
XXXXXXXXXXXXXXXXXXXXXXXXXXXXXXXX
XXXXXXXXXXXXXXXXXXXXXXXXXXXXXXXX
XXXXXXXXXXXXXXXXXXXXXXXXXXXXXXXX
XXXXXXXXXXXXXXXXXXXXXXXXXXXXXXXX
XXXXXXXXXXXXXXXXXXXXXXXXXXXXXXXX
XXXXXXXXXXXXXXXXXXXXXXXXXXXXXXXX
XXXXXXXXXXXXXXXXXXXXXXXXXXXXXXXX
XXXXXXXXXXXXXXXXXXXXXXXXXXXXXXXX
XXXXXXXXXXXXXXXXXXXXXXXXXXXXXXXX
XXXXXXXXXXXXXXXXXXXXXXXXXXXXXXXX
XXXXXXXXXXXXXXXXXXXXXXXXXXXXX/XX
XXXXXXXXXXXXXXXXXXXXXXXXXXXXXXXX