OOOOOOOOOOOOOOOOOOOOOOOOOOOOOOOO
OOOOOOOOOOOOOOOOOOOOOOOOOOOOOOOO
OOOOOOOOOOOOOOOOOOOOOOOOOOOOOOOO
OOOOOOOOOOOOOOOOOOOOOOOOOOOOOOOO
OOOOOOOOOOOOOOOOOOOOOOOOOOOOOOOO
OOOOOOOOOOOOOOOOOOOOOOOOOOOOOOOO
OOOOOOOOOOOOOOOOOOOOOOOOOOOOOOOO
OOOOOOOOOOOOOOOOOOOOOOOOOOOOOOOO
OOOOOOOOOOOOOOOOOOOOOOOOOOOOOOOO
OOOOOOOOOOOOOOOOOOOOOOOOOOOOOOOO
OOOOOOOOOOOOOOOOOOOOOOOOOOOOOOOO
OOOOOOOOOOOOOOOOOOOOOOOOOOOOOOOO
OOOOOOOOOOOOOOOOOOOOOOOOOOOOOOOO
OOOOOOOOOOOOOOOOOOOOOOOOOOOOOOOO
OOOOOOOOOOOOOOOOOOOOOOOOOOOOOOOO
OOOOOOOOOOOOOOOOOOOOOOOOOOOOOOOO
OOOOOOOOOOOOOOOOOOOOOOOOOOOOOOOO
OOOOOOOOOOOOOOOOOOOOOOOOOOOOOOOO
;
SSSSSSSSSSSSSSSXSSSSSSSSSSSSSSSS
SXXXXSSSXXXSSSSXSSSSXXXSSSSSSXSS
SXXXXSSSXXXSSSXXXSSSXXXSSSXXXXXS
SSSSSSSXXXXXXXXXXXXXXXXXSSXXXXXS
SXSSSSSXXXXXXXXXXXXXXXXXSSXXXXXS
SXSSSSSSXXXSSSSXSSSSTXUSSSXXXXXS
SXSSSSSSSSSSSSSXSSSSSSSSSSXXXXXS
SXSSSSSSSSSSSSSXSSSSSSSSSSXSSSSS
XXXXXXXXXXXXXXXSXXXXXXXXXXXXXXXX
SXSSSSSSXXXSSSSXSSSSSSSSSSXSSSSS
SXSSSSSSSXXXSSSXSSSSSSSSSSXSSSSS
SXSSSSSSSSXXXXXXXXXSSSSSSSXSSSSS
SXSSSSSSSSSXXXXXXXXXXXXXXXXSSSSS
SXSSXXXXSSSSXXXXXXXXXXXXXXXSSSSS
SXSSXXXXSSSSSSSXSSSSSSSSSSSSSSSS
SXSSXXXXSSSSSSSXSSSSSSSSSSSSSSSS
SXSSSSSSSSSSSSSXSSSSSSSSSSSSSSSS
SXSSSSSSSSSSSSSSSSSSSSSSSSSSSSSS
;
XXXXXXXXXXXXXXXXXXXXX?XXXXXXX~XX
XXXXXXXXXXXXXXXXXXXXXXXXXXXXXXXX
XXXXXXX~XXXXXXXXXXXXXXXXXXXXXXXX
XXXX|XXXXXXXXXXXXXXXXXXXXXXXXXXX
XXX/XXXXXXXXXXXXXXXXXXXXXXXXXXXX
XXXXXXXXXXXXXXXXXXXXXXXXXXXXXXXX
XXXXXXXXXXXXXXXXXXXXXXXXXXXXXXXX
XXXXXXXX~XXXXXXXXXXXXXXXXXXXXXXX
XXXXXXXXXXXXXXXXXXXXXXXXXXXXXXXX
XXXXXXXXXXXXXXXXXXXXXXXXXXXXXXXX
XXXXXXXXXXXXXXXXXXXXXXXXXXXXXXXX
XXXXXXXXXXXXXXXXXXXXXXXXXXXXXXXX
XXXXXXXXXXXXXXXXXXXXXXXXXXXXXXXX
XXXXXXXXXXXXXXXXXXXXXXXXXXXXXXXX
XXXXXXXXXXXXXXXXXXXXXXXXXXXXXXXX
XXXXXXXXXXXXXXXXXXXXXXXXXXXXXXXX
XXXXXXXXXXXXXXXXXXXXXXXXXXXXXXXX
XXXXXXXXXXXXXXXXXXXXXXXXXXXXXXXX