OOOOOOOOOOOOOOOOOOOOOOOOOOOOOOOO
OOOOOOOOOOOOOOOOOOOOOOOOOOOOOOOO
OOOOOOOOOOOOOOOOOOOOOOOOOOOOOOOO
OOOOOOOOOOOOOOOOOOOOOOOOOOOOOOOO
OOOOOOOOOOOOOOOOOOOOOOOOOOOOOOOO
OOOOOOOOOOOOOOOOOOOOOOOOOOOOOOOO
OOOOOOOOOOOOOOOOOOOOOOOOOOOOOOOO
OOOOOOOOOOOOOOOOOOOOOOOOOOOOOOOO
OOOOOOOOOOOOOOOOOOOOOOOOOOOOOOOO
OOOOOOOOOOOOOOOOOOOOOOOOOOOOOOOO
OOOOOOOOOOOOOOOOOOOOOOOOOOOOOOOO
OOOOOOOOOOOOOOOOOOOOOOOOOOOOOOOO
OOOOOOOOOOOOOOOOOOOOOOOOOOOOOOOO
OOOOOOOOOOOOOOOOOOOOOOOOOOOOOOOO
OOOOOOOOOOOOOOOOOOOOOOOOOOOOOOOO
OOOOOOOOOOOOOOOOOOOOOOOOOOOOOOOO
OOOOOOOOOOOOOOOOOOOOOOOOOOOOOOOO
OOOOOOOOOOOOOOOOOOOOOOOOOOOOOOOO
;
SSSSSSSSSSSSSSSSSSSSSSSSSSSSSSSS
SXXXXSXSXXXXXXXXXXXXXXXXXXXXXXXS
SXXXXSXSXXXXXXXXXXXXXXXXXXXXXXXS
SSSSSSXXXXXXXXXXXXXXXXXXXXXXXXXS
SXXXXSXXXXXXXXXXXXXXXXXXXXXXXXXS
SXXXXSXXXXXXXXXXXXXXXXXXXXXXXXXS
SXSSXSXXXXXXXXXXXXXXXXXXXXXXXXXS
SXSXSSXXXXXXXXXXXXXXXXXXXXXXXXXS
SXSXSSXXXXXXXXXXXXXXXXXXXXXXXXXS
SXSSXXXXXXXXXXXXXXXXXXXXXXXXXXXS
SXSSXSXXXXXXXXXXXXXXXXXXXXXXXXXS
SXSXSSXXXXXXXXXXXXXXXXXXXXXXXXXS
SXSXSSXXXXXXXXXXXXXXXXXXXXXXXXXS
SXSSXXXXXXXXXXXXXXXXXXXXXXXXXXXS
SXSSXSXXXXXXXXXXXXXXXXXXXXXXXXXS
SXSSSXXSXXXXXXXXXXXXXXXXXXXXXXXS
STSSSXXSXXXXXXXXXXXXXXXXXXXXXXXS
SSSSSSSSSSSSSSSSSSSSSSSSSSSSSSSS
;
XXXXXX?XXXXXXXXXXXXXXXXXXXXXXXXX
XXXXXXXXXXXXXXXXXXXXXXXXXXXXXXXX
XXXXXXXXXXXXXXXXXXXXXXXXXXXXXXXX
XXXX/XXXXXXXXXXXXXXXXXXXXXXXXXXX
XXXXXXXXXXXXXXXXXXXXXXXXXXXXXXXX
XXXXXXXXXXXXXXXXXXXXXXXXXXXXXXXX
XXXXXXXXXXXXXXXXXXXXXXXXXXXXXXXX
XXXX/XXXXXXXXXXXXXXXXXXXXXXXXXXX
XXXXXXXXXXXXXXXXXXXXXXXXXXXXXXXX
XXX/XXXXXXXXXXXXXXXXXXXXXXXXXXXX
XXXXXXXXXXXXXXXXXXXXXXXXXXXXXXXX
XXXX/XXXXXXXXXXXXXXXXXXXXXXXXXXX
XXXXXXXXXXXXXXXXXXXXXXXXXXXXXXXX
XXX/XXXXXXXXXXXXXXXXXXXXXXXXXXXX
XXXXXXXXXXXXXXXXXXXXXXXXXXXXXXXX
XXXX/XXXXXXXXXXXXXXXXXXXXXXXXXXX
XTXXXXXXXXXXXXXXXXXXXXXXXXXXXXXX
XXXXX/XXXXXXXXXXXXXXXXXXXXXXXXXX