OOOOOOOOOOOOOOOOOOOOOOOOOOOOOOOO
OOOOOOOOOOOOOOOOOOOOOOOOOOOOOOOO
OOOOOOOOOOOOOOOOOOOOOOOOOOOOOOOO
OOOOOOOOOOOOOOOOOOOOOOOOOOOOOOOO
OOOOOOOOOOOOOOOOOOOOOOOOOOOOOOOO
OOOOOOOOOOOOOOOOOOOOOOOOOOOOOOOO
OOOOOOOOOOOOOOOOOOOOOOOOOOOOOOOO
OOOOOOOOOOOOOOOOOOOOOOOOOOOOOOOO
OOOOOOOOOOOOOOOOOOOOOOOOOOOOOOOO
OOOOOOOOOOOOOOOOOOOOOOOOOOOOOOOO
OOOOOOOOOOOOOOOOOOOOOOOOOOOOOOOO
OOOOOOOOOOOOOOOOOOOOOOOOOOOOOOOO
OOOOOOOOOOOOOOOOOOOOOOOOOOOOOOOO
OOOOOOOOOOOOOOOOOOOOOOOOOOOOOOOO
OOOOOOOOOOOOOOOOOOOOOOOOOOOOOOOO
OOOOOOOOOOOOOOOOOOOOOOOOOOOOOOOO
OOOOOOOOOOOOOOOOOOOOOOOOOOOOOOOO
OOOOOOOOOOOOOOOOOOOOOOOOOOOOOOOO
;
0VVVVVVVVVVVVVVVVVVVVVVVVVVVVVV1
>XXXXXXXXXXXXXXXXXXXXXXXXXXXXXX<
>XXXXXXXXXXXXXXXXXXXXXXXXXXXXXX<
>XXXXXXXXXXXXXXXXXXXXXXXXXXXXXX<
>XXXXXXXXXXXXXXXXXXXXXXXXXXXXXX<
>XXXXXXXXXXXXXXXXXXXXXXXXXXXXXX<
>XXXXXXXXXXXXXXXXXXXXXXXXXXXXXX<
>XXXXXXXXXXXXXXXXXXXXXXXXXXXXXX<
>XXXXXXXXX6^^^^^^^^^^^^7XXXXXXX<
>XXXXXXXXX<0VVVVVVVVVV1>XXXXXXX<
>XXXXXXXXX<>XXXXXXXXXX<>XXXXXXX<
>XXXXXXXXX<>XXXXXXXXXX<>XXXXXXX<
>XXXXXXXXX<3^^^^^7XXXX<>XXXXXXX<
>XXX6^^^^^2SSSSSS3^^^^23^^^7XXX<
>XXX5VVVVVVVVVVVVVVVVVVVVVV4XXX<
>XXXXXXXXXXXXXXXXXXXXXXXXXXXXXX<
>XXXXXXXXXXXXXXXXXXXUXTXXXXXXXX<
3^^^^^^^^^^^^^^^^^^^^^^^^^^^^^^2
;
XXXXXXXXXXXXXXXXXXXXXXXXXXXXXXXX
XXXXXXXXXXXXXXXXXXXXXXXXXXXXXXXX
XXXXXXXXXXXXXXXXXXXXXXXXXXXXXXXX
XXXXXXXXXXXXXXXXXXXXXXXXXXXXXXXX
XXXXXXXXXXXXXXXXXXXXXXXXXXXXXXXX
XXXXXXXXXXXXXXXXXXXXXXXXXXXXXXXX
XXXXXXXXXXXXXXXXXXXXXXXXXXXXXXXX
XXXXXXXXXXXXXXXXXXXXXXXXXXXXXXXX
XXXXXXXXXXXXXX/XXXXXXXXXXXXXXXXX
XXXXXXXXXXXXXXXXXX~XXXXXXXXXXXXX
XXXXXXXXXXXXXXXXXXXXXXXXXXXXXXXX
XXXXXXXXXXXXXXXXXXXXXXXXXXXXXXXX
XXXXXXXXXXXXXXXXXXXXXXXXXXXXXXXX
XXXXXXXXXXXXXXXXXXXXXXXXXXXXXXXX
XXXXXXXXXXXXXXXXXXXXXXXXXXXXXXXX
XXXXXXXXXXXXXXXXXXXXXXXXXXXXXXXX
XXXXXXXXXXXXXXXXXXXXXXXXXXXXXXXX
XXXXXX|XXXXXXXXXXXXXXXXXXXXX/XXX